{
	"LN" : "3",
	"GD" : "500",
	"ET" : "2",
	"ED" : "4",
	"ER" : "2",
	"RS" : "6",
	"PR" : "15",
	"PO" : "30",
	"GL" : [
		["W", "W", "W", "W", "W", "W", "W", "W", "W", "W", "W", "W", "W", "W", "W", "W", "W", "W", "W", "W"],
        ["W", "-", "-", "-", "-", "-", "-", "-", "-", "-", "-", "-", "-", "-", "-", "-", "-", "-", "-", "W"],
       	["W", "-", "O", "O", "O", "O", "O", "O", "O", "-", "-", "O", "O", "O", "O", "O", "O", "O", "-", "W"],
        ["W", "-", "O", "-", "-", "-", "-", "R", "O", "-", "-", "O", "R", "-", "-", "-", "-", "O", "-", "W"],
        ["W", "-", "O", "-", "-", "-", "-", "-", "O", "-", "-", "O", "-", "-", "-", "-", "-", "O", "-", "W"],
        ["W", "-", "O", "1", "-", "-", "-", "-", "O", "-", "-", "O", "-", "-", "-", "-", "3", "O", "-", "W"],
        ["W", "-", "O", "-", "-", "-", "-", "-", "O", "-", "-", "O", "-", "-", "-", "-", "-", "O", "-", "W"],
        ["W", "-", "O", "-", "-", "-", "-", "R", "O", "-", "-", "O", "R", "-", "-", "-", "-", "O", "-", "W"],
        ["W", "-", "O", "O", "O", "O", "O", "O", "O", "-", "-", "O", "O", "O", "O", "O", "O", "O", "-", "W"],
        ["W", "-", "-", "-", "-", "-", "-", "-", "-", "-", "-", "-", "-", "-", "-", "-", "-", "-", "-", "W"],
      	["W", "-", "-", "-", "-", "-", "-", "-", "-", "-", "-", "-", "-", "-", "-", "-", "-", "-", "-", "W"],
        ["W", "-", "O", "O", "O", "O", "O", "O", "O", "-", "-", "O", "O", "O", "O", "O", "O", "O", "-", "W"],
        ["W", "-", "O", "R", "-", "-", "-", "-", "O", "-", "-", "O", "R", "-", "-", "-", "-", "O", "-", "W"],
        ["W", "-", "O", "-", "-", "-", "-", "-", "O", "-", "-", "O", "-", "-", "-", "-", "-", "O", "-", "W"],
      	["W", "-", "O", "-", "-", "-", "-", "2", "O", "-", "-", "O", "-", "-", "-", "-", "-", "O", "-", "W"],
        ["W", "-", "O", "-", "-", "-", "-", "-", "O", "-", "-", "O", "-", "-", "-", "-", "-", "O", "-", "W"],
        ["W", "-", "O", "R", "-", "-", "-", "-", "O", "-", "-", "O", "-", "-", "-", "-", "R", "O", "-", "W"],
        ["W", "-", "O", "O", "O", "O", "O", "O", "O", "-", "-", "O", "O", "O", "O", "O", "O", "O", "-", "W"],
        ["W", "-", "-", "-", "-", "-", "-", "-", "-", "-", "-", "-", "-", "-", "-", "-", "-", "-", "-", "W"],
        ["W", "W", "W", "W", "W", "W", "W", "W", "W", "W", "W", "W", "W", "W", "W", "W", "W", "W", "W", "W"]
        ]
}