{
    "LN": "1",
    "GD": "120",
    "ET": "2",
    "ED": "2",
    "ER": "4",
    "RS": "0.5",
    "PR": "10",
    "PO": "100",
    "GL": [
       	["W", "W", "W", "W", "W", "W", "W", "W", "W", "W", "W", "W", "W", "W", "W", "W", "W", "W", "W"],	
        ["W", "-", "2", "-", "-", "-", "-", "-", "R", "-", "-", "-", "-", "O", "-", "-", "-", "-", "W"],
        ["W", "W", "O", "W", "-", "W", "-", "W", "-", "W", "-", "W", "-", "W", "-", "W", "-", "W", "W"],
        ["W", "-", "O", "-", "-", "-", "-", "-", "-", "-", "-", "R", "-", "-", "-", "-", "-", "-", "W"],
        ["W", "W", "O", "W", "O", "W", "-", "W", "-", "W", "-", "W", "-", "W", "O", "W", "-", "W", "W"],
        ["W", "-", "-", "O", "-", "-", "-", "-", "-", "-", "-", "-", "O", "-", "R", "-", "-", "3", "W"],
        ["W", "W", "O", "W", "-", "W", "-", "W", "-", "W", "-", "W", "-", "W", "-", "W", "-", "W", "W"],
        ["W", "-", "O", "O", "O", "O", "-", "-", "-", "1", "-", "-", "-", "-", "-", "-", "-", "O", "W"],
        ["W", "W", "O", "W", "O", "W", "O", "W", "O", "W", "-", "W", "-", "W", "-", "W", "-", "W", "W"],
        ["W", "-", "-", "O", "O", "O", "O", "-", "-", "R", "-", "-", "O", "O", "O", "-", "-", "-", "W"],
        ["W", "W", "-", "W", "-", "W", "O", "W", "O", "W", "-", "W", "O", "W", "O", "W", "O", "W", "W"],
        ["W", "-", "-", "-", "-", "-", "-", "O", "O", "O", "-", "-", "O", "O", "O", "-", "O", "R", "W"],
        ["W", "W", "W", "W", "W", "W", "W", "W", "W", "W", "W", "W", "W", "W", "W", "W", "W", "W", "W"]
        ]
}