{
	"LN" : "2",
	"GD" : "120",
	"ET" : "1.5",
	"ED" : "1",
	"ER" : "3",
	"RS" : "1",
	"PR" : "10",
	"PO" : "100",
	"GL" : [
		["W", "W", "W", "W", "W", "W", "W", "W", "W", "W", "W", "W", "W", "W", "W", "W", "W", "W", "W"],	
        ["W", "-", "2", "-", "-", "-", "-", "-", "R", "-", "-", "-", "-", "O", "-", "-", "-", "-", "W"],
        ["W", "W", "O", "W", "-", "W", "-", "W", "-", "W", "-", "W", "-", "W", "-", "W", "-", "W", "W"],
        ["W", "-", "O", "-", "-", "O", "-", "-", "-", "-", "-", "R", "-", "-", "-", "-", "-", "-", "W"],
        ["W", "W", "O", "W", "O", "W", "-", "W", "-", "W", "-", "W", "-", "W", "O", "W", "-", "W", "W"],
        ["W", "-", "-", "O", "-", "-", "-", "-", "-", "1", "-", "-", "O", "-", "R", "-", "-", "3", "W"],
        ["W", "W", "-", "W", "-", "W", "-", "W", "-", "W", "-", "W", "-", "W", "-", "W", "-", "W", "W"],
        ["W", "-", "-", "O", "-", "O", "-", "-", "O", "-", "-", "O", "-", "O", "-", "-", "-", "O", "W"],
        ["W", "W", "O", "W", "-", "W", "O", "W", "O", "W", "-", "W", "-", "W", "-", "W", "-", "W", "W"],
        ["W", "-", "-", "O", "-", "O", "O", "-", "-", "R", "-", "-", "-", "W", "-", "-", "-", "-", "W"],
        ["W", "W", "-", "W", "R", "W", "O", "W", "O", "W", "-", "W", "O", "W", "O", "W", "O", "W", "W"],
        ["W", "4", "-", "-", "-", "-", "-", "-", "R", "O", "O", "-", "O", "-", "O", "-", "O", "R", "W"],
        ["W", "W", "W", "W", "W", "W", "W", "W", "W", "W", "W", "W", "W", "W", "W", "W", "W", "W", "W"]
        ]
}
