{
    "LN": "1",
    "GD": "300",
    "ET": "2",
    "ED": "2",
    "ER": "1",
    "RS": "2",
    "PR": "5",
    "PO": "10",
    "GL": [
       	["W", "W", "W", "W", "W", "W", "W", "W", "W", "W", "W", "W", "W", "W", "W", "W", "W", "W", "W", "W"],	
        ["W", "-", "-", "-", "-", "-", "-", "-", "-", "-", "-", "-", "-", "-", "-", "-", "-", "-", "-", "W"],
        ["W", "-", "-", "-", "-", "-", "-", "-", "-", "-", "-", "-", "-", "-", "-", "R", "-", "-", "-", "W"],
        ["W", "-", "R", "-", "-", "-", "-", "-", "-", "-", "-", "-", "-", "-", "-", "-", "-", "-", "-", "W"],
        ["W", "-", "-", "-", "O", "O", "O", "O", "-", "-", "-", "-", "O", "O", "O", "O", "O", "-", "-", "W"],
        ["W", "-", "-", "-", "-", "-", "-", "O", "-", "-", "-", "-", "-", "-", "-", "-", "-", "-", "-", "W"],
        ["W", "-", "-", "-", "-", "-", "-", "O", "-", "-", "-", "-", "-", "-", "-", "-", "-", "2", "-", "W"],
        ["W", "1", "-", "-", "-", "-", "-", "O", "-", "-", "-", "-", "-", "-", "-", "-", "-", "-", "-", "W"],
        ["W", "-", "-", "-", "-", "-", "-", "O", "-", "-", "-", "-", "-", "-", "-", "-", "-", "-", "-", "W"],
        ["W", "-", "-", "-", "O", "O", "O", "O", "-", "-", "-", "-", "O", "O", "O", "O", "O", "-", "-", "W"],
        ["W", "-", "-", "-", "-", "-", "-", "-", "-", "-", "-", "-", "-", "-", "-", "-", "-", "-", "-", "W"],
        ["W", "-", "-", "-", "-", "-", "-", "-", "-", "-", "-", "-", "-", "-", "-", "-", "-", "-", "-", "W"],
        ["W", "-", "-", "-", "-", "O", "-", "-", "-", "-", "-", "-", "O", "O", "O", "O", "O", "-", "-", "W"],
        ["W", "-", "-", "-", "-", "O", "-", "-", "-", "-", "-", "-", "O", "-", "-", "-", "-", "-", "-", "W"],
      	["W", "-", "-", "-", "-", "O", "-", "-", "-", "-", "-", "-", "O", "-", "-", "-", "-", "R", "-", "W"],
        ["W", "-", "O", "O", "O", "O", "O", "O", "O", "-", "-", "-", "O", "-", "-", "-", "-", "-", "-", "W"],
        ["W", "-", "-", "-", "-", "O", "-", "-", "-", "-", "-", "-", "O", "-", "-", "-", "-", "-", "-", "W"],
        ["W", "-", "-", "R", "-", "O", "-", "3", "-", "-", "-", "-", "O", "O", "O", "O", "O", "-", "-", "W"],
        ["W", "-", "-", "-", "-", "O", "-", "-", "-", "-", "-", "-", "-", "-", "-", "-", "-", "-", "-", "W"],
        ["W", "W", "W", "W", "W", "W", "W", "W", "W", "W", "W", "W", "W", "W", "W", "W", "W", "W", "W", "W"]
        ]
}