{
	"LN" : "2",
	"GD" : "400",
	"ET" : "2",
	"ED" : "3",
	"ER" : "3",
	"RS" : "1",
	"PR" : "10",
	"PO" : "20",
	"GL" : [
		["W", "W", "W", "W", "W", "W", "W", "W", "W", "W", "W", "W", "W", "W", "W", "W", "W", "W", "W", "W"],
        ["W", "O", "-", "-", "-", "-", "-", "-", "-", "-", "-", "-", "-", "-", "-", "-", "-", "-", "O", "W"],
        ["W", "-", "-", "-", "-", "-", "-", "-", "-", "-", "-", "-", "-", "-", "-", "R", "-", "-", "-", "W"],
        ["W", "-", "R", "O", "O", "O", "O", "O", "O", "O", "O", "O", "O", "O", "O", "O", "O", "-", "-", "W"],
        ["W", "-", "-", "-", "-", "-", "-", "-", "-", "-", "-", "-", "-", "-", "-", "-", "O", "-", "-", "W"],
        ["W", "-", "-", "-", "-", "-", "-", "-", "-", "-", "-", "-", "-", "-", "-", "-", "O", "-", "-", "W"],
        ["W", "-", "-", "-", "-", "-", "-", "-", "-", "R", "-", "-", "-", "-", "-", "-", "O", "2", "-", "W"],
        ["W", "1", "-", "-", "-", "-", "-", "-", "-", "-", "-", "-", "-", "-", "-", "-", "O", "-", "-", "W"],
        ["W", "-", "-", "-", "-", "-", "-", "-", "-", "-", "-", "-", "-", "-", "-", "-", "O", "-", "-", "W"],
        ["W", "-", "-", "O", "O", "O", "O", "-", "O", "O", "O", "-", "O", "O", "O", "O", "O", "-", "-", "W"],
        ["W", "-", "-", "O", "-", "-", "-", "-", "-", "-", "-", "-", "-", "-", "-", "-", "-", "-", "-", "W"],
        ["W", "-", "-", "O", "-", "-", "-", "-", "-", "R", "-", "-", "-", "-", "-", "-", "-", "-", "-", "W"],
        ["W", "-", "-", "O", "-", "-", "-", "-", "-", "-", "-", "-", "-", "-", "-", "-", "-", "-", "-", "W"],
        ["W", "-", "-", "O", "-", "-", "-", "-", "-", "-", "-", "-", "-", "-", "-", "-", "-", "-", "-", "W"],
      	["W", "-", "-", "O", "-", "-", "-", "-", "-", "-", "-", "-", "-", "-", "-", "-", "-", "R", "-", "W"],
        ["W", "-", "-", "O", "O", "O", "O", "O", "O", "O", "O", "O", "O", "O", "O", "O", "O", "-", "-", "W"],
        ["W", "-", "-", "-", "-", "-", "-", "-", "-", "-", "-", "-", "-", "-", "-", "-", "-", "-", "-", "W"],
        ["W", "-", "-", "R", "-", "-", "-", "3", "-", "-", "-", "-", "-", "-", "-", "-", "-", "-", "-", "W"],
        ["W", "O", "-", "-", "-", "-", "-", "-", "-", "-", "-", "-", "-", "-", "-", "-", "-", "-", "O", "W"],
        ["W", "W", "W", "W", "W", "W", "W", "W", "W", "W", "W", "W", "W", "W", "W", "W", "W", "W", "W", "W"]
        ]
}
