{
	"LN" : "3",
	"GD" : "120",
	"ET" : "1",
	"ED" : "1",
	"ER" : "3",
	"RS" : "2",
	"PR" : "10",
	"PO" : "100",
	"GL" : [
		["W", "W", "W", "W", "W", "W", "W", "W", "W", "W", "W", "W", "W", "W", "W", "W", "W", "W", "W"],	
        ["W", "-", "-", "O", "-", "-", "-", "-", "R", "-", "-", "-", "O", "-", "R", "-", "-", "3", "W"],
        ["W", "W", "O", "W", "-", "W", "-", "W", "-", "W", "-", "W", "-", "W", "-", "W", "-", "W", "W"],
        ["W", "-", "O", "O", "O", "O", "-", "-", "-", "1", "-", "-", "-", "-", "-", "-", "-", "O", "W"],
        ["W", "W", "O", "W", "O", "W", "O", "W", "O", "W", "-", "W", "-", "W", "-", "W", "-", "W", "W"],
        ["W", "-", "2", "-", "-", "-", "-", "-", "-", "-", "-", "-", "O", "-", "R", "-", "-", "3", "W"],
        ["W", "W", "O", "W", "-", "W", "-", "W", "-", "W", "-", "W", "-", "W", "-", "W", "-", "W", "W"],
        ["W", "-", "O", "-", "-", "-", "-", "-", "-", "-", "-", "R", "-", "-", "-", "-", "-", "-", "W"],
        ["W", "W", "O", "W", "O", "W", "-", "W", "-", "W", "-", "W", "-", "W", "O", "W", "-", "W", "W"],
        ["W", "-", "-", "O", "O", "O", "O", "-", "-", "R", "-", "-", "O", "O", "O", "-", "-", "-", "W"],
        ["W", "W", "-", "W", "-", "W", "O", "W", "O", "W", "-", "W", "O", "W", "O", "W", "O", "W", "W"],
        ["W", "-", "-", "-", "-", "-", "4", "O", "O", "O", "-", "-", "O", "O", "-", "-", "-", "R", "W"],
        ["W", "W", "W", "W", "W", "W", "W", "W", "W", "W", "W", "W", "W", "W", "W", "W", "W", "W", "W"]
        ]
}